[
"` /\ ```` /O\ `",
" //\\    //V\\ ",
" |oo|    |o o| ",
" |  | /\\\\  | ",
" |[]| |D| |  | "]